0  0  0  0  0  0  0  0  0  0  0  0  0  0  0  0  0  0  0  0  0  0  0  0  0  0  0  0  0  0  0  0  0  0  0  0  0  0  0  0
0  1  1  1  1  1  1  1  1  1  0  0  0  0  0  0  0  0  0  0  0  0  0  0  0  0  0  0  0  0  0  0  0  0  0  0  0  0  0  0
0  2  2  2  2  2  2  2  2  1  0  0  0  0  0  0  2  2  0  0  2  2  0  0  0  0  0  0  0  0  0  0  0  0  0  0  0  0  0  0
0  2  12 13 13 13 13 14 2  1  0  0  0  0  0  2  43 43 2  2  43 43 2  0  0  0  0  0  0  0  0  0  0  0  0  0  0  0  0  0
0  2  24 20 20 20 20 26 2  1  0  0  0  0  0  2  43 43 2  2  43 43 2  0  0  0  0  0  0  0  0  0  0  0  0  0  0  0  0  0
0  2  24 20 20 20 20 26 2  1  0  0  0  0  0  0  2  2  43 43  2  2 0  0  0  0  0  0  0  0  0  0  0  0  0  0  0  0  0  0
0  2  24 20 20 20 20 26 2  1  0  0  0  0  0  0  2  2  43 43  2  2 0  0  0  0  0  0  0  0  0  1  2  43 2  0  0  0  0  0
0  2  36 37 24 26 37 38 2  1  0  0  0  0  0  2  43 43 43 43 43 43 2  0  0  0  0  0  0  0  0  1  2  43 2  0  0  0  0  0
0  2  2  2  24 26 2  2  2  1  0  0  0  0  0  2  43 43 43 43 43 43 2  0  0  0  0  0  0  0  0  1  2  43 2  0  0  0  0  0
0  1  1  2  24 26 2  1  1  1  0  0  0  0  0  0  2  2  43 43 2  2  0  0  0  0  0  0  0  0  0  0  0  0  0  0  0  0  0  0
0  1  1  2  24 26 2  1  0  0  0  0  0  0  0  0  0  0  0  0  0  0  0  0  0  0  0  0  0  0  0  0  0  0  0  0  0  0  0  0
0  1  1  2  24 26 2  1  0  0  0  0  0  0  0  0  0  0  0  0  0  0  0  0  0  0  0  0  0  0  0  0  0  0  0  0  0  0  0  0
0  1  1  2  24 26 2  1  0  0  0  0  0  0  0  0  0  0  0  0  0  0  0  0  0  0  0  0  0  0  0  0  0  0  0  0  0  0  0  0
0  1  1  2  24 26 2  1  1  1  0  0  0  0  0  0  0  0  0  0  0  0  0  0  0  0  0  0  0  0  0  0  0  0  0  0  0  0  0  0
0  2  2  2  24 26 2  2  2  1  0  0  0  0  0  0  0  0  0  0  0  0  0  0  0  0  0  0  0  0  0  0  0  0  0  0  0  0  0  0
0  2  12 13 24 26 13 14 2  1  0  0  0  0  0  0  0  0  0  0  0  0  0  0  0  0  0  0  0  0  0  0  0  0  0  0  0  0  0  0
0  2  24 20 20 20 20 26 2  1  0  0  0  0  0  0  0  0  0  0  0  0  0  0  0  0  0  0  0  0  0  0  0  0  0  0  0  0  0  0
0  2  24 20 20 20 20 26 2  1  0  0  0  0  0  0  0  0  0  0  0  0  0  0  0  0  0  0  0  0  0  0  0  0  0  0  0  0  0  0
0  2  24 20 20 20 20 26 2  1  0  0  0  0  0  0  0  0  0  0  0  0  0  0  0  0  0  0  0  0  0  1  2  43 2  0  0  0  0  0
0  2  36 37 37 37 37 38 2  1  0  0  0  0  0  0  0  0  0  0  0  0  0  0  0  0  0  0  0  0  0  1  2  43 2  0  0  0  0  0
0  2  2  2  2  2  2  2  2  1  0  0  0  0  0  0  0  0  0  0  0  0  0  0  0  0  0  0  0  0  0  0  0  0  0  0  0  0  0  0
0  0  0  0  0  0  0  0  0  0  0  0  0  0  0  0  0  0  0  0  0  0  0  0  0  0  0  0  0  0  0  0  0  0  0  0  0  0  0  0
0  0  0  0  0  0  0  0  0  0  0  0  0  0  0  0  0  0  0  0  0  0  0  0  0  0  0  0  0  0  0  0  0  0  0  0  0  0  0  0

