0 0 1 1 2 2 2 1 1 0 0 0 0 1 2 2 1 1 0 0 0 1 1 2 2 
10 10 10 10 11 22 22 22 11 21 51 51 50 52 42 41 40 30 30 31 41 51 32 42 40 
0 0 1 1 2 2 2 1 1 0 0 0 0 1 2 2 1 1 0 0 0 1 1 2 2 
1 1 0 0 1 2 2 2 1 1 1 1 0 2 2 1 0 0 0 1 1 1 2 2 0 
0 0 1 1 2 2 2 1 1 0 0 0 0 1 2 2 1 1 0 0 0 1 1 2 2 
1 1 0 0 1 2 2 2 1 1 1 1 0 2 2 1 0 0 0 1 1 1 2 2 0 
0 0 1 1 2 2 2 1 1 0 0 0 0 1 2 2 1 1 0 0 0 1 1 2 2 
1 1 0 0 1 2 2 2 1 1 1 1 0 2 2 1 0 0 0 1 1 1 2 2 0 
0 0 1 1 2 2 2 1 1 0 0 0 0 1 2 2 1 1 0 0 0 1 1 2 2 
1 1 0 0 1 2 2 2 1 1 1 1 0 2 2 1 0 0 0 1 1 1 2 2 0 
0 0 1 1 2 2 2 1 1 0 0 0 0 1 2 2 1 1 0 0 0 1 1 2 2 
1 1 0 0 1 2 2 2 1 1 1 1 0 2 2 1 0 0 0 1 1 1 2 2 0 
0 0 1 1 2 2 2 1 1 0 0 0 0 1 2 2 1 1 0 0 0 1 1 2 2 
1 1 0 0 1 2 2 2 1 1 1 1 0 2 2 1 0 0 0 1 1 1 2 2 0 
0 0 1 1 2 2 2 1 1 0 0 0 0 1 2 2 1 1 0 0 0 1 1 2 2 
1 1 0 0 1 2 2 2 1 1 1 1 0 2 2 1 0 0 0 1 1 1 2 2 0 
0 0 1 1 2 2 2 1 1 0 0 0 0 1 2 2 1 1 0 0 0 1 1 2 2 
1 1 0 0 1 2 2 2 1 1 1 1 0 2 2 1 0 0 0 1 1 1 2 2 0 
0 0 1 1 2 2 2 1 1 0 0 0 0 1 2 2 1 1 0 0 0 1 1 2 2 
1 1 0 0 1 2 2 2 1 1 1 1 0 2 2 1 0 0 0 1 1 1 2 2 0 

