44 45 45 45 45 45 45 45 45 45 45 45 45 45 45 45 45 45 45 45 45 45 45 45 45 45 45 45 45 45 45 45 45 45 45 45 45 45 45 46
58 1  1  1  1  1  1  1  1  1  0  0  0  0  58 5  2  2  5  5  2  2  5  56 0  0  0  0  0  0  0  0  0  0  0  0  0  0  0  56
58 2  2  2  2  2  2  2  2  1  0  0  0  0  58 5  2  2  43 43 2  2  5  56 0  0  0  0  0  0  0  0  0  0  0  0  0  0  0  56
58 2  12 13 13 13 13 14 2  1  0  0  0  0  58 2  43 43 2  2  43 43 2  56 0  0  0  0  0  0  0  48 49 50 51 0  0  0  0  56
58 2  24 25 25 25 25 26 2  1  0  0  0  0  58 2  43 43 2  2  43 43 2  56 0  0  0  0  0  0  0  60 61 62 63 0  0  0  0  56
58 2  24 25 25 25 25 26 2  1  0  0  0  0  58 5  2  2  43 43  2  2 5  56 0  0  0  0  0  0  0  72 73 74 75 0  0  0  0  56
58 2  24 25 25 25 25 26 2  1  0  0  0  0  58 5  2  2  43 43  2  2 5  56 0  0  0  0  0  0  0  1  2  43 2  0  0  0  0  56
58 2  36 37 24 26 37 38 2  1  0  0  0  0  58 2  43 43 43 43 43 43 43 56 0  0  0  0  0  0  0  1  2  43 2  0  0  0  0  56
58 2  2  2  24 26 2  2  2  1  0  0  0  0  58 2  43 43 43 43 43 43 43 56 0  0  0  0  0  0  0  1  2  43 2  0  0  0  0  56
58 1  1  2  24 26 2  1  1  1  0  0  0  0  58 5  2  2  43 43 2  2  5  56 0  0  0  0  0  0  0  0  0  0  0  0  0  0  0  56
58 1  1  2  24 26 2  1  0  0  0  0  0  0  68 45 45 46 0  0  44 45 45 70 0  0  0  0  0  0  0  0  0  0  0  0  0  0  0  56
58 1  1  2  24 26 2  1  0  0  0  0  0  0  0  0  0  58 0  0  56 0  0  0  0  0  0  0  0  0  0  0  0  0  0  0  0  0  0  56
58 1  1  2  24 26 2  1  0  0  0  0  0  0  0  0  0  71 0  0  71 0  0  0  0  0  0  0  0  0  0  0  0  0  0  0  0  0  0  56
58 1  1  2  24 26 2  1  1  1  0  0  0  0  0  0  0  0  0  0  0  0  0  0  0  0  0  0  0  0  0  0  0  0  0  0  0  0  0  56
58 2  2  2  24 26 2  2  2  1  0  0  0  0  0  0  0  0  0  0  0  0  0  0  0  0  0  0  0  0  0  0  0  0  0  0  0  0  0  56
58 2  12 13 24 26 13 14 2  1  0  0  0  0  0  0  0  0  0  0  0  0  0  0  0  0  0  0  0  0  0  52 53 54 55 0  0  0  0  56
58 2  24 25 25 25 25 26 2  1  0  0  0  0  0  0  0  0  0  0  0  0  0  0  0  0  0  0  0  0  0  64 65 66 67 0  0  0  0  56
58 2  24 25 25 25 25 26 2  1  0  0  0  0  0  0  0  0  0  0  0  0  0  0  0  0  0  0  0  0  0  76 77 78 79 0  0  0  0  56
58 2  24 25 25 25 25 26 2  1  0  0  0  0  0  0  0  0  0  0  0  0  0  0  0  0  0  0  0  0  0  1  2  43 2  0  0  0  0  56
58 2  36 37 37 37 37 38 2  1  0  0  0  0  0  0  0  0  0  0  0  0  0  0  0  0  0  0  0  0  0  1  2  43 2  0  0  0  0  56
58 2  2  2  2  2  2  2  2  1  0  0  0  0  0  0  0  0  0  0  0  0  0  0  0  0  0  0  0  0  0  0  0  0  0  0  0  0  0  56
58 0  0  0  0  0  0  0  0  0  0  0  0  0  0  0  0  0  0  0  0  0  0  0  0  0  0  0  0  0  0  0  0  0  0  0  0  0  0  56
68 45 45 45 45 45 45 45 45 45 45 45 45 45 45 45 45 45 45 45 45 45 45 45 45 45 45 45 45 45 45 45 45 45 45 45 45 45 45 70